2137 - Zach - Regular

21412 - Manager Ridwan - Manager
GENERAL-Manager Ridwan - Manager Ridwan - Regular

21321 - Lancaster - Director
MANAGER-Lancaster - Lancaster - Manager
GENERAL-Lancaster - Lancaster - Regular

0198 - Artem - Regular

31023 - Manager Tahmid - Manager
GENERAL-Manager Tahmid - Manager Tahmid - Regular

LOGIN - LOGIN - LOGIN

bookingPrediction-Manager Ridwan - Manager Ridwan - bookingPrediction
clockIn-Manager Ridwan - Manager Ridwan - clockIn
createOrder-Manager Ridwan - Manager Ridwan - createOrder
editMenuScene-Manager Ridwan - Manager Ridwan - editMenuScene
salesAnalysis-Manager Ridwan - Manager Ridwan - salesAnalysis
sickHoliday-Manager Ridwan - Manager Ridwan - sickHoliday
staffHoursScene-Manager Ridwan - Manager Ridwan - staffHoursScene

bookingPrediction-Lancaster - Lancaster - bookingPrediction
clockIn-Lancaster - Lancaster - clockIn
createOrder-Lancaster - Lancaster - createOrder
editMenuScene-Lancaster - Lancaster - editMenuScene
salesAnalysis-Lancaster - Lancaster - salesAnalysis
sickHoliday-Lancaster - Lancaster - sickHoliday
staffHoursScene-Lancaster - Lancaster - staffHoursScene

addWineMenu-Lancaster - Lancaster - addWineMenu
wineCellar-Lancaster - Lancaster - wineCellar


bookingPrediction-Manager Tahmid - Manager Tahmid - bookingPrediction
clockIn-Manager Tahmid - Manager Tahmid - clockIn
createOrder-Manager Tahmid - Manager Tahmid - createOrder
editMenuScene-Manager Tahmid - Manager Tahmid - editMenuScene
salesAnalysis-Manager Tahmid - Manager Tahmid - salesAnalysis
sickHoliday-Manager Tahmid - Manager Tahmid - sickHoliday
staffHoursScene-Manager Tahmid - Manager Tahmid - staffHoursScene


111 - Chef Ronald - Regular
112 - Biba - Regular