2137 - Zach - Regular

21412 - Ridwan - Manager
GENERAL-Ridwan - Ridwan - Regular

21321 - Lancaster - Director
MANAGER-Lancaster - Lancaster - Manager
GENERAL-Lancaster - Lancaster - Regular

0198 - Artem - Regular

31023 - Tahmid - Manager
GENERAL-Tahmid - Tahmid - Regular

LOGIN - LOGIN - LOGIN

bookingPrediction-Ridwan - Ridwan - bookingPrediction
clockIn-Ridwan - Ridwan - clockIn
createOrder-Ridwan - Ridwan - createOrder
editMenuScene-Ridwan - Ridwan - editMenuScene
salesAnalysis-Ridwan - Ridwan - salesAnalysis
sickHoliday-Ridwan - Ridwan - sickHoliday
staffHoursScene-Ridwan - Ridwan - staffHoursScene

bookingPrediction-Lancaster - Lancaster - bookingPrediction
clockIn-Lancaster - Lancaster - clockIn
createOrder-Lancaster - Lancaster - createOrder
editMenuScene-Lancaster - Lancaster - editMenuScene
salesAnalysis-Lancaster - Lancaster - salesAnalysis
sickHoliday-Lancaster - Lancaster - sickHoliday
staffHoursScene-Lancaster - Lancaster - staffHoursScene

addWineMenu-Lancaster - Lancaster - addWineMenu
wineCellar-Lancaster - Lancaster - wineCellar


bookingPrediction-Tahmid - Tahmid - bookingPrediction
clockIn-Tahmid - Tahmid - clockIn
createOrder-Tahmid - Tahmid - createOrder
editMenuScene-Tahmid - Tahmid - editMenuScene
salesAnalysis-Tahmid - Tahmid - salesAnalysis
sickHoliday-Tahmid - Tahmid - sickHoliday
staffHoursScene-Tahmid - Tahmid - staffHoursScene


111 - Chief Ronald - Regular